F 76,77,78
C 97,98,99

NO textures/EG1.xpm ffff
SO textures/EG2.xpm
WE textures/EG3.xpm 
EA textures/EG4.xpm

1111111111111111111
1001001001001000001
1011000N01000001001
1001001001111101111
1001111000001001001
10000000E0000001001
1001111111111001001
1111000000000001011
1000000001000000001
1111111111111111111
